     #-      -#     /
    #=        -#    /
   #=    ,     =#   /
  #-           S-#  /
 #-    ,    ,    -# /
#=                -#/
-     ,        ,   =/
          ,         /
    .   .   .   .   /
O@                  /
--=-H    ,      O O /
  S H          H--=-/
    H  O RD  O H  S /
    H-==---H---H    /
    H      H   H    /
DO  H D O  H O HO  D/
-###################/
